+--------------------------------------------------------------------------------+
|                                                                                |
|                                                                                |
|                                                                                |
|                                                                                |
|                %%                      %             %%%%%%%%%%%               |
|                %%                      %             % %       %               |
|                %%                      %             %  %      %               |
|                %%                      %             %   %     %               |
|        %%%%%%%%%%%%%%%%%%              %             %    %    %               |
|                %%                      %             %     %   %               |
|                %%                      %             %      %  %               |
|                %%                      %             %       % %               |
|                %%                      %             %%%%%%%%%%%               |
|                                                                                |
|                                                                                |
|                                                                                |
|                                                                                |
|   %%%%%%%%%%   %%%%%%%%%%%%   %%%%%%   %%       %%   %%%%%%%%%%%    %%%%%%%%   |
|   %%      %%   %%        %%     %%     %%%      %%        %        %           |
|   %%      %%   %%        %%     %%     %% %     %%        %        %           |
|   %%%%%%%%%%   %%        %%     %%     %%  %    %%        %         %%         |
|   %%           %%        %%     %%     %%   %   %%        %            %%%     |
|   %%           %%        %%     %%     %%    %  %%        %                %   |
|   %%           %%        %%     %%     %%     % %%        %                %   |
|   %%           %%%%%%%%%%%%   %%%%%%   %%      %%%        %        %%%%%%%%    |
|                                                                                |
|                                                                                |
|                                                                                |
|                                                                                |
|                                                                                |
+--------------------------------------------------------------------------------+
